rank,player,nation,position,team,age,born,ninetys,tackles,tackles_won,defensive_third_tackles,middle_third_tackles,attacking_third_tackles,dribblers_tackled,dribbler_tackles_attempted,dribbler_tackled_success_percentage,challenges_lost,total_blocks,shots_blocked,passes_blocked,interceptions,tackles+interceptions,clearances,errors_leading_to_shot
1,Max Aarons,eng ENG,DF,Bournemouth,24-116,2000,13,29,19,20,7,2,20,32,62.5,12,9,5,4,6,35,25,0
2,Bénie Adama Traore,ci CIV,"FW,MF",Sheffield Utd,21-151,2002,4.3,4,2,1,2,1,0,4,0,4,4,1,3,1,5,1,0
3,Tyler Adams,us USA,MF,Bournemouth,25-075,1999,1.2,4,3,1,3,0,2,3,66.7,1,2,0,2,4,8,2,0
4,Tosin Adarabioyo,eng ENG,DF,Fulham,26-218,1997,18,21,11,16,5,0,12,21,57.1,9,16,11,5,25,46,80,0
5,Elijah Adebayo,eng ENG,FW,Luton Town,26-113,1998,13.1,1,0,1,0,0,0,9,0,9,8,1,7,5,6,23,0
6,Simon Adingra,ci CIV,FW,Brighton,22-119,2002,20.9,36,18,18,10,8,15,35,42.9,20,25,1,24,14,50,14,0
7,Nayef Aguerd,ma MAR,DF,West Ham,28-030,1996,20.6,26,14,19,7,0,16,22,72.7,6,33,24,9,17,43,85,2
8,Brandon Aguilera,cr CRC,FW,Nott'ham Forest,20-306,2003,0.1,0,0,0,0,0,0,0,,0,0,0,0,0,0,0,0
9,Naouirou Ahamada,fr FRA,"MF,FW",Crystal Palace,22-031,2002,3.1,10,7,5,5,0,6,14,42.9,8,3,0,3,1,11,3,0
10,Anel Ahmedhodžić,ba BIH,DF,Sheffield Utd,25-034,1999,27.4,58,36,43,13,2,26,45,57.8,19,40,25,15,33,91,132,2
11,Ola Aina,ng NGA,DF,Nott'ham Forest,27-204,1996,16.8,40,25,26,11,3,23,32,71.9,9,18,3,15,16,56,47,1
12,Rayan Aït-Nouri,dz ALG,"DF,MF",Wolves,22-328,2001,23.4,63,39,35,22,6,24,42,57.1,18,28,6,22,13,76,34,0
13,Kristoffer Ajer,no NOR,DF,Brentford,26-012,1998,19.2,36,20,25,8,3,23,36,63.9,13,24,11,13,21,57,76,1
14,Manuel Akanji,ch SUI,"DF,MF",Manchester City,28-285,1995,24.1,36,25,14,15,7,20,34,58.8,14,25,12,13,22,58,64,2
15,Nathan Aké,nl NED,DF,Manchester City,29-071,1995,21.5,25,15,15,7,3,12,19,63.2,7,15,2,13,13,38,53,0
16,Thiago Alcántara,es ESP,MF,Liverpool,33-018,1991,0.1,0,0,0,0,0,0,0,,0,0,0,0,0,0,0,0
17,Trent Alexander-Arnold,eng ENG,DF,Liverpool,25-205,1998,21.2,29,20,19,9,1,21,72,29.2,51,19,2,17,25,54,45,4
18,Alisson,br BRA,GK,Liverpool,31-210,1992,25,0,0,0,0,0,0,1,0,1,0,0,0,0,0,11,3
19,Miguel Almirón,py PAR,FW,Newcastle Utd,30-079,1994,20.5,35,24,12,15,8,11,28,39.3,17,28,2,26,10,45,12,0
20,Edson Álvarez,mx MEX,MF,West Ham,26-188,1997,25.7,79,39,46,26,7,31,63,49.2,32,58,20,38,42,121,80,0
21,Julián Álvarez,ar ARG,"MF,FW",Manchester City,24-089,2000,29.2,24,13,5,8,11,8,31,25.8,23,29,0,29,2,26,14,1
22,Zeki Amdouni,ch SUI,FW,Burnley,23-147,2000,20.8,27,18,1,15,11,7,25,28,18,22,10,12,8,35,10,0
23,Sofyan Amrabat,ma MAR,"MF,DF",Manchester Utd,27-252,1996,7.4,24,15,15,7,2,16,27,59.3,11,12,3,9,5,29,12,2
24,Joachim Andersen,dk DEN,DF,Crystal Palace,27-334,1996,35,52,32,32,18,2,25,35,71.4,10,31,18,13,40,92,191,1
25,Elliot Anderson,sct SCO,"MF,FW",Newcastle Utd,21-175,2002,9.2,20,15,10,8,2,11,24,45.8,13,16,3,13,7,27,20,0
26,Jaidon Anthony,eng ENG,FW,Bournemouth,24-150,1999,1.7,3,1,1,0,2,1,7,14.3,6,3,0,3,1,4,3,0
27,Michail Antonio,jm JAM,FW,West Ham,34-032,1990,16.4,14,7,4,6,4,3,10,30,7,16,3,13,4,18,2,0
28,Antony,br BRA,FW,Manchester Utd,24-065,2000,13.8,39,21,14,19,6,19,38,50,19,26,1,25,11,50,8,0
29,Oliver Arblaster,eng ENG,MF,Sheffield Utd,19-360,2004,8.1,19,11,8,8,3,6,12,50,6,16,7,9,12,31,7,0
30,Cameron Archer,eng ENG,"FW,MF",Sheffield Utd,22-283,2001,18,15,10,6,5,4,6,15,40,9,19,3,16,1,16,10,0
31,Cameron Archer,eng ENG,MF,Aston Villa,22-283,2001,0.1,0,0,0,0,0,0,0,,0,0,0,0,0,0,0,0
32,Alphonse Areola,fr FRA,GK,West Ham,31-062,1993,27,1,1,1,0,0,1,3,33.3,2,0,0,0,1,2,13,0
33,Lorenz Assignon,tg TOG,DF,Burnley,23-312,2000,11.2,27,12,15,9,3,12,24,50,12,19,7,12,14,41,36,1
34,Serge Aurier,ci CIV,"DF,MF",Nott'ham Forest,31-127,1992,9.3,20,14,9,11,0,5,11,45.5,6,10,3,7,9,29,36,1
35,Taiwo Awoniyi,ng NGA,FW,Nott'ham Forest,26-261,1997,11.4,9,7,1,4,4,1,2,50,1,7,2,5,1,10,9,0
36,Jordan Ayew,gh GHA,"FW,MF",Crystal Palace,32-231,1991,28.2,65,36,23,28,14,21,42,50,21,43,2,41,16,81,15,0
37,Benoît Badiashile,fr FRA,DF,Chelsea,23-034,2001,10.2,18,13,11,7,0,9,13,69.2,4,17,11,6,12,30,41,2
38,Leon Bailey,jm JAM,"MF,FW",Aston Villa,26-264,1997,21,10,5,5,3,2,4,17,23.5,13,16,1,15,8,18,6,0
39,George Baldock,gr GRE,DF,Sheffield Utd,31-051,1993,10.8,18,10,10,7,1,6,15,40,9,14,8,6,10,28,33,0
40,Carlos Baleba,cm CMR,MF,Brighton,20-117,2004,13.5,36,17,16,16,4,21,40,52.5,19,31,6,25,17,53,27,3
41,Fodé Ballo-Touré,sn SEN,"DF,MF",Fulham,27-117,1997,0.6,3,2,1,2,0,1,1,100,0,1,0,1,3,6,2,0
42,Shandon Baptiste,gd GRN,MF,Brentford,26-021,1998,2.5,4,4,2,2,0,1,5,20,4,5,1,4,3,7,6,0
43,Valentín Barco,ar ARG,"DF,FW",Brighton,19-281,2004,2,5,2,3,1,1,3,5,60,2,3,0,3,2,7,2,1
44,Ross Barkley,eng ENG,MF,Luton Town,30-146,1993,27.7,47,19,16,21,10,11,48,22.9,37,21,7,14,25,72,50,2
45,Harvey Barnes,eng ENG,"FW,MF",Newcastle Utd,26-142,1997,7.5,5,1,2,2,1,1,2,50,1,0,0,0,3,8,2,0
46,Chris Basham,eng ENG,"DF,MF",Sheffield Utd,35-284,1988,3.6,7,2,4,3,0,2,9,22.2,7,9,4,5,5,12,17,0
47,Calvin Bassey,ng NGA,DF,Fulham,24-120,1999,22.6,44,25,31,12,1,18,25,72,7,26,9,17,27,71,76,4
48,Owen Beck,wls WAL,DF,Liverpool,21-264,2002,0.1,2,1,1,1,0,0,0,,0,0,0,0,0,2,1,0
49,Donny van de Beek,nl NED,DF,Manchester Utd,27-011,1997,0,0,0,0,0,0,0,0,,0,1,0,1,0,0,0,0
50,Amari'i Bell,jm JAM,DF,Luton Town,29-360,1994,19.1,50,33,30,19,1,22,35,62.9,13,33,15,18,25,75,60,1
51,Jean-Ricner Bellegarde,fr FRA,"MF,FW",Wolves,25-307,1998,9,15,9,7,6,2,6,13,46.2,7,17,2,15,7,22,13,0
52,Anis Ben Slimane,tn TUN,MF,Sheffield Utd,23-044,2001,4.3,10,6,5,1,4,4,10,40,6,6,1,5,5,15,6,0
53,Saïd Benrahma,dz ALG,"FW,MF",West Ham,28-263,1995,6.9,8,4,5,3,0,4,15,26.7,11,8,0,8,5,13,7,0
54,Rodrigo Bentancur,uy URU,MF,Tottenham,26-309,1997,8.6,18,11,10,6,2,8,21,38.1,13,13,4,9,11,29,14,1
55,Daniel Bentley,eng ENG,GK,Wolves,30-291,1993,3.3,0,0,0,0,0,0,0,,0,0,0,0,0,0,1,0
56,Jóhann Berg Guðmundsson,is ISL,MF,Burnley,33-185,1990,12.4,13,4,6,5,2,7,15,46.7,8,14,0,14,15,28,16,0
57,Sander Berge,no NOR,MF,Burnley,26-075,1998,30.4,72,43,32,35,5,32,55,58.2,23,46,18,28,23,95,56,2
58,Luke Berry,eng ENG,"MF,DF",Luton Town,31-292,1992,3.5,7,2,2,4,1,2,2,100,0,5,0,5,0,7,3,0
59,Beto,gw GNB,FW,Everton,26-089,1998,10.4,14,6,1,6,7,4,11,36.4,7,11,0,11,1,15,14,0
60,Jordan Beyer,de GER,DF,Burnley,23-346,2000,13.7,35,20,22,12,1,14,24,58.3,10,22,15,7,16,51,68,1
61,Philip Billing,dk DEN,MF,Bournemouth,27-323,1996,15.1,32,15,6,22,4,9,27,33.3,18,29,5,24,19,51,28,1
62,Yves Bissouma,ml MLI,MF,Tottenham,27-243,1996,20.5,73,47,29,34,10,39,55,70.9,16,26,5,21,33,106,41,3
63,Benicio Boaitey,eng ENG,"DF,FW",Brighton,20-111,2004,0.2,0,0,0,0,0,0,0,,0,0,0,0,0,0,2,0
64,Oscar Bobb,no NOR,"FW,MF",Manchester City,20-292,2003,3.3,6,3,1,2,3,1,3,33.3,2,4,0,4,4,10,1,0
65,Jayden Bogle,eng ENG,DF,Sheffield Utd,23-277,2000,28,61,32,42,17,2,33,65,50.8,32,40,11,29,29,90,86,0
66,Willy Boly,ci CIV,DF,Nott'ham Forest,33-086,1991,13,40,23,33,7,0,20,30,66.7,10,24,17,7,22,62,71,0
67,Sven Botman,nl NED,DF,Newcastle Utd,24-108,2000,15.3,20,13,14,6,0,8,13,61.5,5,20,16,4,9,29,61,3
68,Jarrod Bowen,eng ENG,FW,West Ham,27-131,1996,31.5,40,26,14,13,13,13,35,37.1,22,35,5,30,19,59,14,0
69,Conor Bradley,nir NIR,DF,Liverpool,20-295,2003,8.1,32,24,13,12,7,23,37,62.2,14,17,1,16,10,42,14,0
70,Jarrad Branthwaite,eng ENG,DF,Everton,21-307,2002,31.6,60,30,37,21,2,42,56,75,14,43,31,12,49,109,147,1
71,Ben Brereton,cl CHI,"FW,MF",Sheffield Utd,25-011,1999,9.5,9,4,4,4,1,4,10,40,6,7,3,4,3,12,12,0
72,Rhian Brewster,eng ENG,"FW,MF",Sheffield Utd,24-028,2000,3.4,5,1,1,2,2,0,2,0,2,2,0,2,0,5,2,0
73,Armando Broja,al ALB,FW,Chelsea,22-232,2001,5,3,0,0,1,2,1,2,50,1,5,1,4,0,3,3,0
74,Armando Broja,al ALB,FW,Fulham,22-232,2001,0.7,0,0,0,0,0,0,0,,0,1,0,1,0,0,0,0
75,Andre Brooks,eng ENG,"MF,DF",Sheffield Utd,20-253,2003,8.8,18,11,7,10,1,7,19,36.8,12,12,1,11,12,30,16,0
76,David Brooks,wls WAL,"FW,MF",Bournemouth,26-296,1997,3.1,5,4,2,1,2,2,4,50,2,3,0,3,2,7,2,0
77,Jacob Brown,sct SCO,"MF,FW",Luton Town,26-019,1998,11.3,19,12,7,7,5,7,18,38.9,11,20,1,19,8,27,22,0
78,Josh Brownhill,eng ENG,MF,Burnley,28-132,1995,23.9,55,34,22,24,9,24,34,70.6,10,32,8,24,33,88,39,1
79,Jacob Bruun Larsen,dk DEN,"MF,FW",Burnley,25-223,1998,11.8,7,3,3,2,2,5,16,31.3,11,13,0,13,6,13,19,0
80,Hugo Bueno,es ESP,"DF,MF",Wolves,21-224,2002,7.3,20,14,11,7,2,11,18,61.1,7,15,4,11,5,25,21,0
81,Santiago Bueno,uy URU,DF,Wolves,25-172,1998,8,12,6,5,7,0,4,9,44.4,5,20,10,10,6,18,30,0
82,Facundo Buonanotte,ar ARG,"FW,MF",Brighton,19-128,2004,13,36,17,8,21,7,12,37,32.4,25,18,3,15,7,43,4,0
83,Reece Burke,eng ENG,DF,Luton Town,27-240,1996,16.5,33,21,16,11,6,10,24,41.7,14,24,18,6,17,50,72,1
84,Dan Burn,eng ENG,DF,Newcastle Utd,31-356,1992,26.3,54,28,33,19,2,22,57,38.6,35,47,20,27,35,89,109,1
85,Mason Burstow,eng ENG,FW,Chelsea,20-269,2003,0.1,0,0,0,0,0,0,0,,0,0,0,0,0,0,0,0
86,Moisés Caicedo,ec ECU,MF,Chelsea,22-179,2001,27.1,75,39,34,30,11,30,50,60,20,43,19,24,30,105,37,4
87,Tom Cairney,sct SCO,MF,Fulham,33-100,1991,15.7,23,15,10,11,2,13,25,52,12,16,4,12,13,36,5,0
88,Dominic Calvert-Lewin,eng ENG,FW,Everton,27-044,1997,21.6,12,5,1,6,5,2,14,14.3,12,13,4,9,4,16,33,0
89,Thomas Cannon,ie IRL,FW,Everton,21-123,2002,0,0,0,0,0,0,0,0,,0,0,0,0,0,0,0,0
90,Diego Carlos,br BRA,DF,Aston Villa,31-045,1993,17.2,25,14,20,4,1,13,20,65,7,19,14,5,13,38,66,3
91,Cesare Casadei,it ITA,"FW,MF",Chelsea,21-110,2003,0.5,2,1,1,1,0,0,0,,0,1,0,1,0,2,3,0
92,Casemiro,br BRA,"MF,DF",Manchester Utd,32-066,1992,18,64,41,30,27,7,36,81,44.4,45,65,26,39,15,79,55,0
93,Matty Cash,pl POL,DF,Aston Villa,26-266,1997,23.1,51,29,22,24,5,27,55,49.1,28,35,14,21,18,69,56,0
94,Timothy Castagne,be BEL,DF,Fulham,28-146,1995,27.3,45,22,21,15,9,24,41,58.5,17,35,9,26,38,83,61,1
95,Jonny Castro,es ESP,MF,Wolves,30-057,1994,0.1,0,0,0,0,0,0,1,0,1,1,1,0,0,0,0,0
96,Trevoh Chalobah,eng ENG,DF,Chelsea,24-299,1999,5.7,9,6,4,1,4,4,4,100,0,4,4,0,5,14,26,0
97,Calum Chambers,eng ENG,"DF,MF",Aston Villa,29-100,1995,0.8,0,0,0,0,0,0,0,,0,2,1,1,0,0,4,0
98,Youssef Chermiti,pt POR,FW,Everton,19-341,2004,1.9,1,1,1,0,0,0,3,0,3,3,1,2,1,2,1,0
99,Ben Chilwell,eng ENG,DF,Chelsea,27-130,1996,8.4,15,10,5,9,1,5,8,62.5,3,11,3,8,4,19,19,1
100,Tawanda Chirewa,eng ENG,"MF,FW",Wolves,20-201,2003,1.6,6,2,3,2,1,1,2,50,1,0,0,0,1,7,0,0
101,Leon Chiwome,eng ENG,FW,Wolves,18-110,2006,1.9,2,1,0,1,1,1,2,50,1,3,1,2,0,2,2,0
102,Tahith Chong,nl NED,MF,Luton Town,24-147,1999,19.1,31,18,17,11,3,11,27,40.7,16,25,5,20,6,37,8,1
103,Ryan Christie,sct SCO,MF,Bournemouth,29-067,1995,29.4,76,37,31,30,15,35,79,44.3,44,46,9,37,49,125,45,0
104,Carney Chukwuemeka,eng ENG,"MF,FW",Chelsea,20-192,2003,2.5,6,4,3,3,0,1,3,33.3,2,1,1,0,0,6,1,0
105,Bobby Clark,eng ENG,MF,Liverpool,19-082,2005,1,2,1,1,1,0,1,5,20,4,6,2,4,1,3,1,0
106,Jordan Clark,eng ENG,MF,Luton Town,30-220,1993,13.1,27,15,11,11,5,10,35,28.6,25,24,3,21,10,37,10,1
107,Nathaniel Clyne,eng ENG,DF,Crystal Palace,33-024,1991,12,23,15,11,10,2,14,20,70,6,15,5,10,9,32,28,0
108,Séamus Coleman,ie IRL,DF,Everton,35-201,1988,5.1,14,12,8,3,3,9,14,64.3,5,8,4,4,5,19,14,1
109,Nathan Collins,ie IRL,DF,Brentford,22-365,2001,27.5,36,20,22,12,2,19,29,65.5,10,42,27,15,40,76,136,4
110,Levi Colwill,eng ENG,DF,Chelsea,21-063,2003,20,48,30,26,17,5,26,34,76.5,8,28,10,18,26,74,66,0
111,Lewis Cook,eng ENG,MF,Bournemouth,27-086,1997,28,56,38,24,28,4,31,55,56.4,24,27,9,18,59,115,42,1
112,Jack Cork,eng ENG,MF,Burnley,34-309,1989,0.2,2,0,0,2,0,1,3,33.3,2,0,0,0,0,2,1,0
113,Maxwel Cornet,ci CIV,"MF,FW",West Ham,27-215,1996,1.2,3,2,3,0,0,1,5,20,4,2,0,2,2,5,1,0
114,Vladimír Coufal,cz CZE,DF,West Ham,31-251,1992,31.8,58,38,45,11,2,34,65,52.3,31,42,11,31,39,97,92,0
115,Philippe Coutinho,br BRA,"MF,FW",Aston Villa,31-322,1992,0.3,0,0,0,0,0,0,1,0,1,0,0,0,0,0,0,0
116,Aaron Cresswell,eng ENG,"DF,FW",West Ham,34-136,1989,3.6,2,1,1,0,1,1,2,50,1,4,2,2,3,5,6,0
117,Marc Cucurella,es ESP,DF,Chelsea,25-282,1998,14.8,44,28,23,17,4,24,46,52.2,22,28,11,17,15,59,35,0
118,Josh Cullen,ie IRL,MF,Burnley,28-022,1996,20,34,23,12,19,3,21,40,52.5,19,28,17,11,12,46,24,0
119,Matheus Cunha,br BRA,"FW,MF",Wolves,24-338,1999,24.4,29,15,8,17,4,13,35,37.1,22,25,7,18,13,42,20,1
120,Mahmoud Dahoud,de GER,MF,Brighton,28-119,1996,5,9,4,2,4,3,3,9,33.3,6,4,1,3,1,10,5,0
121,Ameen Al-Dakhil,be BEL,DF,Burnley,22-054,2002,11.7,12,5,4,7,1,1,10,10,9,13,6,7,12,24,38,2
122,Diogo Dalot,pt POR,DF,Manchester Utd,25-042,1999,31.3,72,44,51,11,10,44,64,68.8,20,42,15,27,35,107,94,0
123,Mikkel Damsgaard,dk DEN,MF,Brentford,23-301,2000,7.3,27,16,13,8,6,13,36,36.1,23,20,1,19,10,37,7,1
124,Danilo,br BRA,MF,Nott'ham Forest,23-000,2001,17,27,15,15,11,1,15,34,44.1,19,30,8,22,30,57,33,0
125,Arnaut Danjuma,nl NED,"MF,FW",Everton,27-089,1997,6.6,6,4,2,3,1,1,4,25,3,4,0,4,3,9,0,0
126,Jayden Danns,eng ENG,FW,Liverpool,18-104,2006,0.1,0,0,0,0,0,0,0,,0,0,0,0,0,0,0,0
127,Josh Dasilva,eng ENG,"DF,FW",Brentford,25-189,1998,0.3,2,1,0,1,1,0,0,,0,0,0,0,0,2,0,0
128,David Datro Fofana,ci CIV,FW,Burnley,21-129,2002,9.7,10,5,3,5,2,3,6,50,3,8,3,5,1,11,2,0
129,Ben Davies,wls WAL,DF,Tottenham,31-005,1993,12.1,23,17,13,7,3,16,21,76.2,5,17,15,2,10,33,35,0
130,Tom Davies,eng ENG,MF,Sheffield Utd,25-304,1998,2.5,10,5,4,3,3,3,9,33.3,6,2,1,1,3,13,6,1
131,Craig Dawson,eng ENG,DF,Wolves,33-359,1990,24.5,30,20,23,6,1,22,34,64.7,12,51,39,12,16,46,120,1
132,Kevin De Bruyne,be BEL,MF,Manchester City,32-306,1991,10.1,9,7,1,5,3,5,14,35.7,9,5,0,5,2,11,4,0
133,Hannes Delcroix,be BEL,DF,Burnley,25-061,1999,6.5,10,6,6,4,0,3,4,75,1,9,3,6,9,19,26,0
134,Leander Dendoncker,be BEL,MF,Aston Villa,29-014,1995,1.3,6,4,3,2,1,4,5,80,1,5,2,3,2,8,3,1
135,Moussa Diaby,fr FRA,"FW,MF",Aston Villa,24-297,1999,21.4,12,5,5,4,3,4,18,22.2,14,8,1,7,6,18,4,0
136,Amad Diallo,ci CIV,FW,Manchester Utd,21-293,2002,1.7,5,2,0,4,1,2,2,100,0,1,0,1,0,5,1,0
137,Amadou Diallo,eng ENG,MF,Newcastle Utd,21-074,2003,0,0,0,0,0,0,0,0,,0,0,0,0,0,0,0,0
138,Rúben Dias,pt POR,DF,Manchester City,26-351,1997,25.4,36,18,13,20,3,18,25,72,7,30,16,14,25,61,73,0
139,Luis Díaz,co COL,FW,Liverpool,27-107,1997,26.8,29,22,5,13,11,7,28,25,21,15,0,15,3,32,8,0
140,Eric Dier,eng ENG,DF,Tottenham,30-105,1994,2.2,2,1,2,0,0,2,2,100,0,3,3,0,2,4,12,0
141,Lucas Digne,fr FRA,DF,Aston Villa,30-284,1993,23.8,41,18,30,9,2,23,41,56.1,18,15,2,13,24,65,54,0
142,Issa Diop,fr FRA,DF,Fulham,27-111,1997,13.8,25,14,19,5,1,12,17,70.6,5,22,16,6,14,39,68,1
143,Axel Disasi,fr FRA,DF,Chelsea,26-049,1998,28.6,33,19,20,10,3,23,30,76.7,7,26,19,7,18,51,102,2
144,Ben Doak,sct SCO,FW,Liverpool,18-170,2005,0.2,0,0,0,0,0,0,0,,0,0,0,0,0,0,0,0
145,Lewis Dobbin,eng ENG,MF,Everton,21-117,2003,2.3,7,6,3,3,1,5,9,55.6,4,4,1,3,1,8,0,0
146,Matt Doherty,ie IRL,"DF,MF",Wolves,32-104,1992,11.6,27,15,15,9,3,10,19,52.6,9,13,4,9,6,33,43,0
147,Jeremy Doku,be BEL,"FW,MF",Manchester City,21-338,2002,16.2,33,21,12,11,10,9,19,47.4,10,11,0,11,9,42,4,0
148,Nicolás Domínguez,ar ARG,"MF,FW",Nott'ham Forest,25-306,1998,16.5,62,33,34,27,1,23,48,47.9,25,31,5,26,18,80,24,0
149,Jamie Donley,eng ENG,FW,Tottenham,19-117,2005,0,0,0,0,0,0,0,0,,0,0,0,0,0,0,3,0
150,Abdoulaye Doucouré,ml MLI,"FW,MF",Everton,31-119,1993,26.9,42,26,19,14,9,17,42,40.5,25,22,2,20,15,57,15,0
151,Cheick Doucouré,ml MLI,MF,Crystal Palace,24-112,2000,10.2,34,17,15,13,6,18,30,60,12,13,2,11,20,54,12,0
152,Alfie Doughty,eng ENG,DF,Luton Town,24-130,1999,29.5,57,36,28,16,13,33,75,44,42,44,7,37,29,86,36,3
153,Tommy Doyle,eng ENG,MF,Wolves,22-195,2001,13.4,25,12,11,9,5,14,23,60.9,9,22,9,13,12,37,18,0
154,Radu Drăgușin,ro ROU,DF,Tottenham,22-086,2002,2.6,1,1,1,0,0,1,1,100,0,4,4,0,5,6,14,0
155,Martin Dúbravka,sk SVK,GK,Newcastle Utd,35-105,1989,19.1,0,0,0,0,0,0,4,0,4,0,0,0,0,0,6,1
156,Paul Dummett,wls WAL,DF,Newcastle Utd,32-216,1991,0.2,1,0,1,0,0,1,1,100,0,0,0,0,0,1,1,0
157,Lewis Dunk,eng ENG,DF,Brighton,32-160,1991,29.4,25,12,15,9,1,12,33,36.4,21,47,36,11,30,55,77,1
158,Jhon Durán,co COL,"FW,MF",Aston Villa,20-138,2003,3.9,5,4,2,1,2,1,4,25,3,6,0,6,1,6,8,0
159,George Earthy,eng ENG,FW,West Ham,19-237,2004,0.1,0,0,0,0,0,0,0,,0,0,0,0,1,1,0,0
160,Ederson,br BRA,GK,Manchester City,30-256,1993,28.2,0,0,0,0,0,0,1,0,1,0,0,0,0,0,8,1
161,Odsonne Édouard,fr FRA,"FW,MF",Crystal Palace,26-104,1998,16.6,23,11,8,7,8,3,17,17.6,14,17,1,16,6,29,19,0
162,John Egan,ie IRL,DF,Sheffield Utd,31-192,1992,5.4,6,4,4,2,0,4,11,36.4,7,10,4,6,13,19,39,1
163,Hjalmar Ekdal,se SWE,DF,Burnley,25-191,1998,4.3,4,2,2,2,0,2,4,50,2,10,5,5,6,10,18,0
164,Anthony Elanga,se SWE,"FW,MF",Nott'ham Forest,22-002,2002,25.1,32,18,19,6,7,16,34,47.1,18,22,2,20,7,39,19,1
165,Harvey Elliott,eng ENG,"MF,FW",Liverpool,21-025,2003,12.4,23,16,6,14,3,10,29,34.5,19,22,0,22,6,29,7,0
166,Mohamed Elneny,eg EGY,MF,Arsenal,31-293,1992,0.3,0,0,0,0,0,0,1,0,1,0,0,0,1,1,0,0
167,Emerson,br BRA,DF,Tottenham,25-106,1999,11.1,31,21,19,9,3,19,35,54.3,16,17,8,9,20,51,46,1
168,Julio Enciso,py PAR,"MF,FW",Brighton,20-097,2004,2.9,2,1,2,0,0,0,3,0,3,7,0,7,0,2,2,0
169,Wataru Endo,jp JPN,MF,Liverpool,31-080,1993,16.6,40,23,7,28,5,17,49,34.7,32,21,2,19,19,59,27,3
170,Christian Eriksen,dk DEN,MF,Manchester Utd,32-075,1992,11.4,17,13,4,10,3,11,32,34.4,21,15,5,10,4,21,12,0
171,Maxime Estève,fr FRA,DF,Burnley,21-339,2002,12.1,21,7,10,11,0,14,26,53.8,12,19,9,10,21,42,48,0
172,Pervis Estupiñán,ec ECU,DF,Brighton,26-099,1998,13.8,26,13,12,11,3,14,30,46.7,16,14,4,10,21,47,20,0
173,Jonny Evans,nir NIR,DF,Manchester Utd,36-117,1988,12.3,12,7,10,2,0,9,16,56.3,7,22,16,6,18,30,66,0
174,Eberechi Eze,eng ENG,"MF,FW",Crystal Palace,25-305,1998,20,28,11,2,15,11,12,28,42.9,16,22,2,20,10,38,5,0
175,Łukasz Fabiański,pl POL,GK,West Ham,39-011,1985,8,1,0,1,0,0,1,2,50,1,0,0,0,1,2,4,0
176,Romain Faivre,fr FRA,"FW,MF",Bournemouth,25-290,1998,0.4,1,1,0,1,0,0,3,0,3,0,0,0,0,1,0,0
177,Ansu Fati,es ESP,"MF,FW",Brighton,21-181,2002,5.6,4,2,1,2,1,1,11,9.1,10,8,0,8,3,7,3,0
178,Felipe,br BRA,DF,Nott'ham Forest,34-349,1989,4.2,12,9,9,3,0,9,12,75,3,4,1,3,4,16,12,0
179,Evan Ferguson,ie IRL,FW,Brighton,19-193,2004,15.2,14,6,4,7,3,5,14,35.7,9,10,3,7,2,16,8,0
180,Bruno Fernandes,pt POR,"MF,FW",Manchester Utd,29-234,1994,33,66,37,26,24,16,29,86,33.7,57,47,6,41,25,91,47,2
181,Enzo Fernández,ar ARG,MF,Chelsea,23-103,2001,24.5,50,22,22,18,10,27,65,41.5,38,36,13,23,17,67,28,0
182,John Fleck,sct SCO,"MF,DF",Sheffield Utd,32-249,1991,1,1,0,0,1,0,0,1,0,1,0,0,0,0,1,1,0
183,Mark Flekken,nl NED,GK,Brentford,30-321,1993,33.5,1,1,1,0,0,1,5,20,4,1,0,1,0,1,17,1
184,Phil Foden,eng ENG,"FW,MF",Manchester City,23-337,2000,28,28,18,11,9,8,12,25,48,13,22,0,22,13,41,17,1
185,Wes Foderingham,eng ENG,GK,Sheffield Utd,33-106,1991,26.4,5,3,5,0,0,5,6,83.3,1,0,0,0,0,5,14,6
186,Pablo Fornals,es ESP,"MF,FW",West Ham,28-067,1996,4.7,10,6,4,3,3,5,16,31.3,11,8,1,7,6,16,7,0
187,Omari Forson,eng ENG,FW,Manchester Utd,19-284,2004,0.7,2,0,0,2,0,1,1,100,0,0,0,0,0,2,0,0
188,Lyle Foster,za RSA,"FW,MF",Burnley,23-239,2000,18.2,19,10,5,6,8,6,15,40,9,12,3,9,3,22,31,0
189,Matheus França,br BRA,"MF,FW",Crystal Palace,20-028,2004,2.6,3,3,2,1,0,1,7,14.3,6,4,0,4,1,4,1,0
190,Nathan Fraser,ie IRL,FW,Wolves,19-067,2005,2.1,5,2,2,1,2,1,3,33.3,2,2,1,1,1,6,2,0
191,Cody Gakpo,nl NED,"FW,MF",Liverpool,24-358,1999,15.6,24,16,6,13,5,6,18,33.3,12,19,4,15,12,36,7,0
192,Conor Gallagher,eng ENG,MF,Chelsea,24-083,2000,29.9,74,45,29,29,16,30,63,47.6,33,45,10,35,39,113,19,0
193,Idrissa Gana Gueye,sn SEN,MF,Everton,34-216,1989,18.1,65,41,28,23,14,25,42,59.5,17,20,6,14,22,87,13,0
194,Alejandro Garnacho,ar ARG,FW,Manchester Utd,19-303,2004,24.6,20,13,7,5,8,10,39,25.6,29,24,2,22,16,36,18,0
195,James Garner,eng ENG,MF,Everton,23-047,2001,30.8,77,41,30,35,12,33,79,41.8,46,42,13,29,45,122,43,1
196,Saman Ghoddos,ir IRN,DF,Brentford,30-236,1993,7.9,26,17,19,5,2,17,28,60.7,11,9,2,7,5,31,11,0
197,Morgan Gibbs-White,eng ENG,"MF,FW",Nott'ham Forest,24-093,2000,32.1,34,23,6,18,10,14,31,45.2,17,28,6,22,16,50,18,0
198,Bryan Gil,es ESP,"FW,MF",Tottenham,23-078,2001,2.2,1,0,0,0,1,1,3,33.3,2,3,0,3,3,4,4,0
199,Alfie Gilchrist,eng ENG,DF,Chelsea,20-153,2003,1.3,2,0,2,0,0,1,3,33.3,2,5,3,2,1,3,4,0
200,Billy Gilmour,sct SCO,MF,Brighton,22-323,2001,20.8,23,15,13,8,2,10,32,31.3,22,22,8,14,9,32,14,1
201,Ben Godfrey,eng ENG,DF,Everton,26-105,1998,11.4,27,18,17,6,4,13,25,52,12,12,7,5,16,43,51,0
202,André Gomes,pt POR,"MF,FW",Everton,30-274,1993,5,7,4,2,3,2,3,12,25,9,10,1,9,3,10,3,1
203,João Gomes,br BRA,MF,Wolves,23-077,2001,26.4,110,67,59,41,10,38,86,44.2,48,48,6,42,18,128,29,2
204,Toti Gomes,pt POR,DF,Wolves,25-104,1999,27.8,43,25,31,8,4,23,34,67.6,11,36,16,20,24,67,83,1
205,Joe Gomez,eng ENG,DF,Liverpool,26-342,1997,18.5,45,29,24,14,7,28,60,46.7,32,26,4,22,17,62,47,2
206,Sergio Gómez,es ESP,"FW,MF",Manchester City,23-238,2000,0.6,1,0,0,1,0,1,2,50,1,0,0,0,1,2,0,0
207,Anthony Gordon,eng ENG,FW,Newcastle Utd,23-065,2001,29.2,51,32,14,28,9,21,61,34.4,40,26,0,26,7,58,6,0
208,Kaide Gordon,eng ENG,FW,Liverpool,19-207,2004,0,0,0,0,0,0,0,0,,0,0,0,0,0,0,0,0
209,Daniel Gore,eng ENG,MF,Manchester Utd,19-216,2004,0,1,1,0,1,0,1,1,100,0,0,0,0,1,2,0,0
210,Ryan Gravenberch,nl NED,MF,Liverpool,21-349,2002,11.9,23,10,5,10,8,9,26,34.6,17,18,1,17,13,36,11,0
211,Ivo Grbić,hr CRO,GK,Sheffield Utd,28-102,1996,8.6,0,0,0,0,0,0,1,0,1,1,0,1,0,0,9,1
212,Jack Grealish,eng ENG,"FW,MF",Manchester City,28-232,1995,11.1,13,8,6,7,0,6,12,50,6,12,2,10,6,19,5,0
213,Pascal Groß,de GER,"MF,DF",Brighton,32-319,1991,30.6,65,42,31,18,16,28,61,45.9,33,38,8,30,21,86,29,3
214,Marc Guéhi,eng ENG,DF,Crystal Palace,23-291,2000,21.2,26,17,21,5,0,13,23,56.5,10,22,17,5,18,44,86,1
215,Bruno Guimarães,br BRA,MF,Newcastle Utd,26-165,1997,32.3,74,40,39,26,9,32,69,46.4,37,48,13,35,31,105,20,0
216,Malo Gusto,fr FRA,DF,Chelsea,20-346,2003,17.9,50,24,31,14,5,31,47,66,16,28,4,24,15,65,39,1
217,Joško Gvardiol,hr CRO,DF,Manchester City,22-097,2002,21.9,45,29,16,20,9,18,31,58.1,13,29,12,17,23,68,32,3
218,Erling Haaland,no NOR,FW,Manchester City,23-283,2000,24.6,5,2,0,3,2,2,3,66.7,1,10,1,9,2,7,13,0
219,Antwoine Hackford,eng ENG,FW,Sheffield Utd,20-040,2004,0.1,0,0,0,0,0,0,0,,0,0,0,0,0,0,0,0
220,Lewis Hall,eng ENG,DF,Newcastle Utd,19-234,2004,4.7,19,13,11,8,0,10,18,55.6,8,12,0,12,5,24,11,0
221,Gustavo Hamer,nl NED,MF,Sheffield Utd,26-310,1997,29.3,36,19,17,14,5,14,54,25.9,40,28,5,23,28,64,32,0
222,Luke Harris,wls WAL,MF,Fulham,19-026,2005,0.8,1,1,1,0,0,0,1,0,1,0,0,0,0,1,0,0
223,Jack Harrison,eng ENG,"MF,FW",Everton,27-161,1996,23.6,32,17,9,11,12,14,44,31.8,30,23,4,19,12,44,24,0
224,Daiki Hashioka,jp JPN,DF,Luton Town,24-348,1999,5.6,11,5,6,4,1,5,11,45.5,6,10,6,4,8,19,19,0
225,Kai Havertz,de GER,"MF,FW",Arsenal,24-323,1999,26.3,28,13,4,18,6,12,36,33.3,24,26,1,25,17,45,21,0
226,Jan Paul van Hecke,nl NED,DF,Brighton,23-326,2000,26.3,47,26,25,19,3,27,45,60,18,49,27,22,30,77,76,4
227,Hwang Hee-chan,kr KOR,"FW,MF",Wolves,28-094,1996,20.9,19,9,11,7,1,8,22,36.4,14,19,1,18,8,27,9,0
228,Dean Henderson,eng ENG,GK,Crystal Palace,27-048,1997,15,1,1,1,0,0,1,2,50,1,0,0,0,0,1,8,2
229,Rico Henry,eng ENG,DF,Brentford,26-296,1997,4.5,7,5,3,3,1,6,7,85.7,1,8,3,5,5,12,5,1
230,Son Heung-min,kr KOR,FW,Tottenham,31-296,1992,27.6,15,9,5,5,5,7,17,41.2,10,4,1,3,8,23,4,0
231,Aaron Hickey,sct SCO,DF,Brentford,21-324,2002,7.9,16,9,9,3,4,7,7,100,0,7,3,4,3,19,10,0
232,James Hill,eng ENG,DF,Bournemouth,22-110,2002,0.8,3,2,1,2,0,1,1,100,0,3,2,1,3,6,8,0
233,Jack Hinshelwood,eng ENG,DF,Brighton,19-018,2005,9.7,14,5,7,4,3,5,13,38.5,8,6,2,4,14,28,18,0
234,Mason Holgate,eng ENG,DF,Sheffield Utd,27-190,1996,7.6,11,7,5,5,1,5,11,45.5,6,11,4,7,10,21,39,0
235,Callum Hudson-Odoi,eng ENG,"FW,MF",Nott'ham Forest,23-174,2000,17.7,13,5,2,4,7,5,22,22.7,17,14,1,13,6,19,11,0
236,Will Hughes,eng ENG,MF,Crystal Palace,29-012,1995,20.1,59,32,30,18,11,22,46,47.8,24,35,13,22,19,78,25,0
237,Pierre Højbjerg,dk DEN,MF,Tottenham,28-268,1995,13,27,15,10,15,2,12,31,38.7,19,21,7,14,19,46,28,1
238,Rasmus Højlund,dk DEN,FW,Manchester Utd,21-085,2003,21.7,10,6,2,3,5,5,13,38.5,8,6,1,5,1,11,18,0
239,Igor,br BRA,DF,Brighton,26-082,1998,14.2,20,13,4,14,2,13,23,56.5,10,15,7,8,13,33,42,1
240,Danny Ings,eng ENG,FW,West Ham,31-281,1992,4.1,6,2,0,6,0,4,11,36.4,7,4,1,3,3,9,6,0
241,Tim Iroegbunam,eng ENG,MF,Aston Villa,20-304,2003,1.6,7,5,4,2,1,4,9,44.4,5,3,0,3,2,9,2,0
242,Alexander Isak,se SWE,FW,Newcastle Utd,24-221,1999,21.6,4,0,2,1,1,1,7,14.3,6,15,1,14,5,9,10,0
243,Alex Iwobi,ng NGA,MF,Everton,27-362,1996,1.6,2,0,1,0,1,2,3,66.7,1,2,0,2,1,3,0,0
244,Alex Iwobi,ng NGA,"FW,MF",Fulham,27-362,1996,21.4,25,16,11,13,1,10,23,43.5,13,14,0,14,13,38,9,0
245,Nicolas Jackson,sn SEN,FW,Chelsea,22-314,2001,26.1,15,11,2,7,6,3,21,14.3,18,19,5,14,4,19,15,0
246,Reece James,eng ENG,DF,Chelsea,24-143,1999,4.3,13,8,10,2,1,8,10,80,2,4,4,0,3,16,7,1
247,Vitaly Janelt,de GER,"MF,DF",Brentford,25-355,1998,31.5,62,37,29,24,9,31,63,49.2,32,31,9,22,34,96,61,2
248,Mathias Jensen,dk DEN,MF,Brentford,28-119,1996,23.5,52,31,24,21,7,25,94,26.6,69,40,6,34,21,73,25,1
249,Gabriel Jesus,br BRA,FW,Arsenal,27-026,1997,16.1,23,16,11,5,7,5,18,27.8,13,23,1,22,12,35,12,0
250,Raúl Jiménez,mx MEX,FW,Fulham,32-360,1991,14.2,16,11,3,8,5,7,19,36.8,12,9,2,7,3,19,12,0
251,João Pedro,br BRA,"FW,MF",Brighton,22-216,2001,19.7,28,14,10,12,6,12,20,60,8,13,1,12,10,38,25,0
252,Joelinton,br BRA,"MF,FW",Newcastle Utd,27-259,1996,12.6,30,22,16,12,2,10,30,33.3,20,19,5,14,17,47,11,1
253,Ryan John Giles,eng ENG,"DF,MF",Luton Town,24-094,2000,5.6,8,6,4,3,1,2,7,28.6,5,2,0,2,4,12,22,0
254,Ben Johnson,eng ENG,"DF,FW",West Ham,24-096,2000,6,11,7,7,3,1,9,14,64.3,5,2,1,1,5,16,14,0
255,Brennan Johnson,wls WAL,FW,Tottenham,22-342,2001,18.3,22,13,13,4,5,11,29,37.9,18,29,0,29,8,30,12,1
256,Brennan Johnson,wls WAL,"FW,MF",Nott'ham Forest,22-342,2001,2.6,4,1,1,1,2,2,4,50,2,4,1,3,0,4,0,0
257,Joseph Johnson,eng ENG,DF,Luton Town,18-068,2006,0,0,0,0,0,0,0,0,,0,0,0,0,0,0,0,0
258,Sam Johnstone,eng ENG,GK,Crystal Palace,31-035,1993,20,1,0,1,0,0,1,1,100,0,0,0,0,1,2,5,0
259,Curtis Jones,eng ENG,MF,Liverpool,23-090,2001,12.7,26,14,12,11,3,10,23,43.5,13,22,0,22,7,33,8,0
260,Jorginho,it ITA,MF,Arsenal,32-131,1991,10.2,24,10,6,10,8,11,23,47.8,12,17,1,16,12,36,7,1
261,Diogo Jota,pt POR,FW,Liverpool,27-147,1996,12.7,23,13,6,13,4,10,23,43.5,13,9,1,8,7,30,4,0
262,Mads Juel Andersen,dk DEN,DF,Luton Town,26-124,1997,4.4,6,5,4,2,0,4,4,100,0,9,6,3,8,14,29,0
263,Hamed Junior Traorè,ci CIV,MF,Bournemouth,24-073,2000,0.5,1,0,1,0,0,1,3,33.3,2,3,0,3,0,1,0,0
264,Mathias Jørgensen,dk DEN,DF,Brentford,34-006,1990,11.1,15,11,13,1,1,9,16,56.3,7,9,5,4,12,27,38,0
265,Issa Kaboré,bf BFA,DF,Luton Town,22-353,2001,19.2,52,28,23,21,8,24,45,53.3,21,22,11,11,16,68,56,2
266,Sasa Kalajdzic,at AUT,FW,Wolves,26-297,1997,1.8,6,2,3,2,1,1,2,50,1,3,0,3,1,7,6,0
267,Boubacar Kamara,fr FRA,MF,Aston Villa,24-158,1999,18.4,43,29,16,21,6,24,47,51.1,23,21,7,14,21,64,16,0
268,Willy Kambwala,fr FRA,DF,Manchester Utd,19-248,2004,3.5,2,0,1,1,0,1,3,33.3,2,6,3,3,4,6,14,1
269,Thomas Kaminski,be BEL,GK,Luton Town,31-189,1992,35,2,1,2,0,0,2,6,33.3,4,1,0,1,0,2,13,2
270,Loris Karius,de GER,GK,Newcastle Utd,30-312,1993,1,0,0,0,0,0,0,0,,0,0,0,0,0,0,1,0
271,Michael Keane,eng ENG,DF,Everton,31-109,1993,4.9,7,3,3,3,1,1,7,14.3,6,5,4,1,5,12,18,1
272,Thilo Kehrer,de GER,"DF,MF",West Ham,27-221,1996,0.2,1,1,0,1,0,0,0,,0,2,2,0,0,1,0,0
273,Caoimhín Kelleher,ie IRL,GK,Liverpool,25-158,1998,10,0,0,0,0,0,0,0,,0,0,0,0,0,0,4,1
274,Lloyd Kelly,eng ENG,DF,Bournemouth,25-206,1998,16.2,24,19,10,9,5,14,24,58.3,10,19,9,10,10,34,66,0
275,Omari Kellyman,eng ENG,FW,Aston Villa,18-227,2005,0.2,0,0,0,0,0,0,1,0,1,0,0,0,0,0,0,0
276,Milos Kerkez,hu HUN,DF,Bournemouth,20-174,2003,20.9,46,25,30,13,3,29,40,72.5,11,31,11,20,19,65,58,1
277,Kaine Kesler-Hayden,eng ENG,DF,Aston Villa,21-189,2002,0,0,0,0,0,0,0,0,,0,0,0,0,0,0,0,0
278,Max Kilman,eng ENG,DF,Wolves,26-342,1997,35,46,20,39,6,1,24,32,75,8,54,28,26,36,82,171,4
279,Jakub Kiwior,pl POL,DF,Arsenal,24-074,2000,10.5,20,12,11,8,1,14,19,73.7,5,11,3,8,8,28,28,1
280,Justin Kluivert,nl NED,"MF,FW",Bournemouth,24-360,1999,18.9,24,12,4,10,10,6,25,24,19,14,1,13,6,30,10,0
281,Luca Koleosho,it ITA,"MF,FW",Burnley,19-227,2004,10.8,7,4,2,5,0,2,10,20,8,13,0,13,2,9,0,0
282,Ibrahima Konaté,fr FRA,DF,Liverpool,24-340,1999,17.5,36,22,22,13,1,18,24,75,6,18,12,6,20,56,51,1
283,Ezri Konsa,eng ENG,DF,Aston Villa,26-189,1997,31.1,44,26,25,16,3,21,24,87.5,3,35,20,15,27,71,70,3
284,Cheikhou Kouyaté,sn SEN,MF,Nott'ham Forest,34-130,1989,2.3,8,5,3,3,2,1,4,25,3,4,1,3,2,10,10,0
285,Mateo Kovačić,hr CRO,MF,Manchester City,29-359,1994,14.3,32,23,15,12,5,15,21,71.4,6,18,1,17,4,36,10,0
286,Emil Krafth,se SWE,DF,Newcastle Utd,29-271,1994,6.1,19,13,9,6,4,11,21,52.4,10,6,1,5,6,25,12,0
287,Dejan Kulusevski,se SWE,"FW,MF",Tottenham,24-004,2000,26.8,58,30,19,19,20,22,61,36.1,39,21,1,20,14,72,2,1
288,Adam Lallana,eng ENG,"MF,FW",Brighton,35-355,1988,8.8,8,3,4,4,0,0,4,0,4,2,1,1,3,11,1,0
289,Tariq Lamptey,gh GHA,"DF,FW",Brighton,23-212,2000,8.5,17,12,12,4,1,10,19,52.6,9,5,2,3,5,22,4,0
290,Aymeric Laporte,es ESP,DF,Manchester City,29-338,1994,0.1,0,0,0,0,0,0,0,,0,1,1,0,0,0,1,0
291,Yasser Larouci,dz ALG,DF,Sheffield Utd,23-119,2001,5.3,16,8,9,5,2,9,13,69.2,4,6,1,5,7,23,20,1
292,Jamaal Lascelles,eng ENG,DF,Newcastle Utd,30-170,1993,12,14,9,7,7,0,6,11,54.5,5,17,12,5,5,19,42,0
293,Roméo Lavia,be BEL,MF,Chelsea,20-114,2004,0.4,1,0,0,1,0,0,0,,0,0,0,0,0,1,1,0
294,Mario Lemina,ga GAB,MF,Wolves,30-241,1993,30.5,81,53,42,29,10,19,40,47.5,21,32,8,24,39,120,59,0
295,Clément Lenglet,fr FRA,DF,Aston Villa,28-317,1995,11.8,13,9,7,5,1,7,12,58.3,5,18,10,8,6,19,47,1
296,Bernd Leno,de GER,GK,Fulham,32-056,1992,35,0,0,0,0,0,0,0,,0,0,0,0,0,0,13,1
297,Jefferson Lerma,co COL,"MF,DF",Crystal Palace,29-187,1994,26.5,41,24,14,23,4,18,39,46.2,21,31,12,19,36,77,72,0
298,Rico Lewis,eng ENG,"DF,MF",Manchester City,19-160,2004,8.9,10,7,4,4,2,3,7,42.9,4,7,1,6,4,14,6,0
299,Keane Lewis-Potter,eng ENG,"FW,DF",Brentford,23-067,2001,14.6,17,7,5,11,1,7,15,46.7,8,10,2,8,6,23,22,0
300,Victor Lindelöf,se SWE,DF,Manchester Utd,29-287,1994,14.8,15,10,8,7,0,5,13,38.5,8,18,9,9,12,27,40,1
301,Valentino Livramento,eng ENG,DF,Newcastle Utd,21-169,2002,12.6,21,11,15,5,1,8,17,47.1,9,12,5,7,21,42,34,0
302,Giovani Lo Celso,ar ARG,MF,Tottenham,28-020,1996,5.3,20,12,8,8,4,9,14,64.3,5,4,1,3,5,25,2,0
303,Tom Lockyer,wls WAL,DF,Luton Town,29-148,1994,13,25,16,17,6,2,15,22,68.2,7,23,13,10,23,48,68,0
304,Sean Longstaff,eng ENG,MF,Newcastle Utd,26-182,1997,27.1,51,29,16,27,8,22,59,37.3,37,37,7,30,15,66,22,0
305,Max Lowe,eng ENG,"DF,MF",Sheffield Utd,26-354,1997,4.4,20,10,12,5,3,8,15,53.3,7,7,3,4,5,25,13,0
306,Douglas Luiz,br BRA,MF,Aston Villa,25-356,1998,30.4,55,36,20,26,9,24,49,49,25,31,7,24,20,75,18,2
307,Saša Lukić,rs SRB,MF,Fulham,27-260,1996,11.6,32,18,9,17,6,17,38,44.7,21,17,5,12,15,47,16,1
308,Ian Maatsen,nl NED,"FW,MF",Chelsea,22-050,2002,2.3,3,2,1,1,1,0,4,0,4,4,0,4,3,6,10,0
309,Alexis Mac Allister,ar ARG,MF,Liverpool,25-127,1998,26.3,90,50,32,44,14,54,116,46.6,62,62,7,55,32,122,23,0
310,James Maddison,eng ENG,MF,Tottenham,27-158,1996,20.2,28,16,4,15,9,14,28,50,14,14,3,11,11,39,10,1
311,Noni Madueke,eng ENG,FW,Chelsea,22-050,2002,7.8,12,7,5,4,3,8,23,34.8,15,9,0,9,3,15,8,0
312,Gabriel Magalhães,br BRA,DF,Arsenal,26-132,1997,31.2,45,25,22,22,1,15,20,75,5,40,30,10,27,72,95,1
313,Harry Maguire,eng ENG,DF,Manchester Utd,31-055,1993,18.4,24,17,14,10,0,12,22,54.5,10,33,24,9,25,49,83,1
314,Kobbie Mainoo,eng ENG,MF,Manchester Utd,19-010,2005,17.6,37,21,15,14,8,17,35,48.6,18,17,11,6,19,56,28,1
315,Orel Mangala,be BEL,MF,Nott'ham Forest,26-042,1998,17.4,27,13,16,10,1,14,29,48.3,15,12,6,6,26,53,32,0
316,Benson Manuel,be BEL,"MF,FW",Burnley,27-032,1997,1.1,3,2,2,1,0,0,0,,0,1,0,1,0,3,0,0
317,Solly March,eng ENG,"FW,DF",Brighton,29-284,1994,6.2,19,14,9,7,3,8,14,57.1,6,5,0,5,11,30,8,0
318,Anthony Martial,fr FRA,FW,Manchester Utd,28-146,1995,5,4,1,1,1,2,1,1,100,0,4,0,4,0,4,3,0
319,Gabriel Martinelli,br BRA,FW,Arsenal,22-316,2001,21.1,27,23,8,10,9,11,26,42.3,15,20,1,19,5,32,8,1
320,Emiliano Martínez,ar ARG,GK,Aston Villa,31-240,1992,32.5,0,0,0,0,0,0,0,,0,0,0,0,0,0,11,2
321,Lisandro Martínez,ar ARG,DF,Manchester Utd,26-102,1998,6.4,11,7,8,3,0,5,12,41.7,7,9,7,2,4,15,23,0
322,Han-Noah Massengo,fr FRA,"MF,DF",Burnley,22-297,2001,0.2,1,1,1,0,0,0,0,,0,1,0,1,0,1,0,0
323,Pape Matar Sarr,sn SEN,MF,Tottenham,21-228,2002,18.9,31,22,11,14,6,14,32,43.8,18,18,4,14,25,56,24,0
324,Jean-Philippe Mateta,fr FRA,FW,Crystal Palace,26-306,1997,23,19,13,4,10,5,5,9,55.6,4,13,4,9,4,23,12,0
325,Joël Matip,cm CMR,DF,Liverpool,32-265,1991,8.7,12,6,7,4,1,8,12,66.7,4,16,12,4,9,21,43,0
326,Alex Matos,eng ENG,MF,Chelsea,19-209,2004,0,0,0,0,0,0,0,0,,0,0,0,0,0,0,0,0
327,Remi Matthews,eng ENG,GK,Crystal Palace,30-079,1994,0,0,0,0,0,0,0,0,,0,0,0,0,0,0,1,0
328,Neal Maupay,fr FRA,FW,Brentford,27-259,1996,14.5,10,7,4,5,1,3,13,23.1,10,10,0,10,2,12,3,0
329,Neal Maupay,fr FRA,FW,Everton,27-259,1996,1.2,0,0,0,0,0,0,1,0,1,2,0,2,0,0,1,0
330,Konstantinos Mavropanos,gr GRE,DF,West Ham,26-140,1997,15.7,26,14,15,9,2,15,19,78.9,4,20,12,8,23,49,77,3
331,Bryan Mbeumo,cm CMR,FW,Brentford,24-266,1999,18.8,14,10,6,5,3,4,16,25,12,18,1,17,6,20,12,0
332,James Mcatee,eng ENG,"MF,FW",Sheffield Utd,21-194,2002,20,32,21,9,13,10,13,33,39.4,20,20,0,20,11,43,18,0
333,James Mcatee,eng ENG,MF,Manchester City,21-194,2002,0,0,0,0,0,0,0,0,,0,1,0,1,0,0,0,0
334,Oliver McBurnie,sct SCO,FW,Sheffield Utd,27-330,1996,14.2,17,7,4,7,6,5,12,41.7,7,18,2,16,5,22,28,0
335,James McConnell,eng ENG,MF,Liverpool,19-229,2004,0,0,0,0,0,0,0,0,,0,1,0,1,1,1,0,0
336,John McGinn,sct SCO,"MF,FW",Aston Villa,29-194,1994,30.4,55,33,17,31,7,31,73,42.5,42,28,3,25,21,76,20,0
337,Scott McKenna,sct SCO,DF,Nott'ham Forest,27-169,1996,4.6,4,0,3,1,0,2,3,66.7,1,6,4,2,5,9,27,0
338,Dwight McNeil,eng ENG,"MF,FW",Everton,24-159,1999,29.4,42,25,16,12,14,23,52,44.2,29,42,7,35,19,61,35,0
339,Scott McTominay,sct SCO,"MF,FW",Manchester Utd,27-143,1996,18.1,44,22,20,22,2,20,31,64.5,11,32,12,20,12,56,47,0
340,Ben Mee,eng ENG,DF,Brentford,34-221,1989,14.1,26,15,12,12,2,17,22,77.3,5,21,13,8,13,39,63,1
341,Hannibal Mejbri,tn TUN,"MF,FW",Manchester Utd,21-099,2003,1.5,3,3,1,2,0,1,3,33.3,2,1,1,0,0,3,0,0
342,Teden Mengi,eng ENG,DF,Luton Town,21-365,2002,25.3,48,18,30,17,1,16,27,59.3,11,35,25,10,52,100,132,0
343,Chris Mepham,wls WAL,DF,Bournemouth,26-176,1997,6.9,12,11,9,3,0,9,14,64.3,5,13,6,7,7,19,30,1
344,Lewis Miley,eng ENG,MF,Newcastle Utd,17-364,2006,13.4,33,21,6,20,7,15,32,46.9,17,20,3,17,8,41,18,2
345,James Milner,eng ENG,"DF,MF",Brighton,38-116,1986,8.6,20,14,9,10,1,9,14,64.3,5,9,0,9,8,28,16,0
346,Tyrone Mings,eng ENG,DF,Aston Villa,31-047,1993,0.3,0,0,0,0,0,0,0,,0,0,0,0,1,1,1,0
347,Tyrick Mitchell,eng ENG,"DF,MF",Crystal Palace,24-241,1999,32.8,96,53,71,18,7,39,53,73.6,14,58,10,48,25,121,101,0
348,Kaoru Mitoma,jp JPN,FW,Brighton,26-345,1997,16.5,13,6,3,7,3,5,19,26.3,14,15,1,14,5,18,12,0
349,Aleksandar Mitrović,rs SRB,FW,Fulham,29-226,1994,0.4,0,0,0,0,0,0,0,,0,0,0,0,0,0,0,0
350,Jakub Moder,pl POL,MF,Brighton,25-022,1999,5.6,14,7,5,4,5,9,14,64.3,5,7,2,5,2,16,8,0
351,Kudus Mohammed,gh GHA,"FW,MF",West Ham,23-271,2000,24.6,58,43,25,23,10,20,38,52.6,18,24,0,24,9,67,9,1
352,Gonzalo Montiel,ar ARG,DF,Nott'ham Forest,27-119,1997,6.2,17,12,10,5,2,12,21,57.1,9,7,2,5,6,23,29,1
353,Kieffer Moore,wls WAL,"FW,MF",Bournemouth,31-265,1992,1.2,0,0,0,0,0,0,0,,0,0,0,0,0,0,0,0
354,Álex Moreno,es ESP,DF,Aston Villa,30-326,1993,11.4,18,12,18,0,0,12,19,63.2,7,11,2,9,13,31,37,0
355,Carlton Morris,eng ENG,"FW,MF",Luton Town,28-135,1995,28.8,11,7,3,3,5,5,11,45.5,6,21,4,17,1,12,45,0
356,Mason Mount,eng ENG,"MF,FW",Manchester Utd,25-110,1999,4.9,20,12,5,9,6,4,14,28.6,10,6,1,5,6,26,2,0
357,Divin Mubama,eng ENG,FW,West Ham,19-187,2004,0.9,0,0,0,0,0,0,0,,0,0,0,0,0,0,0,0
358,Mykhailo Mudryk,ua UKR,FW,Chelsea,23-115,2001,14.6,20,12,9,6,5,9,28,32.1,19,10,1,9,7,27,8,0
359,Rodrigo Muniz,br BRA,FW,Fulham,22-361,2001,16.3,6,2,1,5,0,1,6,16.7,5,8,3,5,4,10,17,0
360,Daniel Muñoz,co COL,"DF,MF",Crystal Palace,27-339,1996,13,45,30,28,11,6,18,35,51.4,17,26,7,19,22,67,40,0
361,Arijanet Muric,xk KVX,GK,Burnley,25-174,1998,7,1,1,1,0,0,1,1,100,0,0,0,0,0,1,7,3
362,Murillo,br BRA,DF,Nott'ham Forest,21-300,2002,28,44,27,32,11,1,17,30,56.7,13,36,20,16,30,74,164,0
363,Alex Murphy,ie IRL,"DF,FW",Newcastle Utd,19-309,2004,0.1,1,1,0,1,0,1,2,50,1,1,0,1,1,2,0,0
364,Jacob Murphy,eng ENG,"FW,DF",Newcastle Utd,29-065,1995,10.3,16,9,6,4,6,10,20,50,10,15,0,15,4,20,13,0
365,Vitaliy Mykolenko,ua UKR,DF,Everton,24-336,1999,27.4,69,38,46,21,2,41,66,62.1,25,36,11,25,36,105,92,0
366,Marvelous Nakamba,zw ZIM,MF,Luton Town,30-101,1994,12.6,40,24,24,14,2,24,42,57.1,18,23,6,17,11,51,11,1
367,Michael Ndiweni,eng ENG,FW,Newcastle Utd,20-149,2003,0,0,0,0,0,0,0,0,,0,0,0,0,0,0,0,0
368,Reiss Nelson,eng ENG,FW,Arsenal,24-141,1999,3,9,6,5,1,3,8,10,80,2,5,1,4,1,10,5,0
369,Zack Nelson,eng ENG,"MF,DF",Luton Town,19-218,2004,0.1,1,0,1,0,0,0,0,,0,0,0,0,0,1,0,0
370,Neto,br BRA,GK,Bournemouth,34-285,1989,31,0,0,0,0,0,0,0,,0,1,0,1,1,1,12,2
371,Pedro Neto,pt POR,"FW,MF",Wolves,24-051,2000,16.7,7,3,3,2,2,5,15,33.3,10,5,1,4,4,11,2,0
372,Moussa Niakhate,sn SEN,DF,Nott'ham Forest,28-052,1996,14.9,34,21,27,7,0,15,20,75,5,18,11,7,13,47,45,0
373,Eddie Nketiah,eng ENG,FW,Arsenal,24-335,1999,12,12,7,2,6,4,2,7,28.6,5,11,0,11,4,16,4,0
374,Christopher Nkunku,fr FRA,"FW,MF",Chelsea,26-167,1997,3.5,2,1,0,2,0,0,0,,0,3,0,3,2,4,3,0
375,Rhys Norrington-Davies,wls WAL,DF,Sheffield Utd,25-007,1999,1.2,1,1,1,0,0,0,1,0,1,2,0,2,1,2,2,0
376,Oliver Norwood,nir NIR,MF,Sheffield Utd,33-017,1991,16,41,26,18,18,5,20,47,42.6,27,24,9,15,21,62,39,0
377,Matheus Nunes,pt POR,MF,Wolves,25-246,1998,2,3,1,3,0,0,2,6,33.3,4,0,0,0,6,9,1,0
378,Matheus Nunes,pt POR,MF,Manchester City,25-246,1998,7.2,10,4,1,7,2,5,16,31.3,11,6,1,5,1,11,8,1
379,Darwin Núñez,uy URU,FW,Liverpool,24-310,1999,22.2,21,12,2,10,9,11,23,47.8,12,17,6,11,3,24,9,0
380,Ethan Nwaneri,eng ENG,FW,Arsenal,17-039,2007,0.2,0,0,0,0,0,0,0,,0,1,0,1,0,0,0,0
381,Christian Nørgaard,dk DEN,MF,Brentford,30-050,1994,25.2,76,48,41,27,8,29,80,36.3,51,41,3,38,49,125,50,0
382,Mark O'Mahony,ie IRL,FW,Brighton,19-106,2005,0.7,,0,,,,,,,,,,,0,,,
383,Dara O'Shea,ie IRL,DF,Burnley,25-056,1999,29.1,33,16,18,12,3,10,23,43.5,13,36,26,10,28,61,145,2
384,Michael Obafemi,ie IRL,"FW,MF",Burnley,23-298,2000,0.2,0,0,0,0,0,0,0,,0,1,0,1,0,0,0,0
385,Wilson Odobert,fr FRA,"MF,FW",Burnley,19-153,2004,20.3,15,12,6,5,4,6,22,27.3,16,26,2,24,5,20,11,0
386,Odeluga Offiah,eng ENG,DF,Brighton,21-186,2002,1.3,1,0,1,0,0,1,1,100,0,0,0,0,1,2,0,0
387,Chiedozie Ogbene,ie IRL,"MF,DF",Luton Town,26-364,1997,21.1,17,10,10,7,0,12,22,54.5,10,14,3,11,5,22,33,2
388,Angelo Ogbonna,it ITA,DF,West Ham,35-342,1988,5.1,8,3,7,1,0,5,6,83.3,1,12,9,3,2,10,26,0
389,Michael Olakigbe,eng ENG,"DF,FW",Brentford,20-004,2004,0.7,3,0,2,1,0,2,4,50,2,7,0,7,1,4,0,1
390,Michael Olise,fr FRA,"FW,MF",Crystal Palace,22-139,2001,11.3,17,8,7,9,1,8,22,36.4,14,16,0,16,8,25,9,0
391,Robin Olsen,se SWE,GK,Aston Villa,34-112,1990,2.5,0,0,0,0,0,0,0,,0,0,0,0,0,0,1,0
392,Andrew Omobamidele,ie IRL,DF,Nott'ham Forest,21-311,2002,8.7,10,3,9,1,0,5,8,62.5,3,12,8,4,13,23,42,1
393,Amadou Onana,be BEL,MF,Everton,22-257,2001,20.8,60,33,27,26,7,16,37,43.2,21,22,5,17,15,75,27,0
394,André Onana,cm CMR,GK,Manchester Utd,28-027,1996,34,1,0,1,0,0,1,1,100,0,0,0,0,0,1,10,2
395,Ryan One,sct SCO,FW,Sheffield Utd,17-308,2006,0.1,0,0,0,0,0,0,0,,0,0,0,0,0,0,0,0
396,Tyler Onyango,eng ENG,MF,Everton,21-056,2003,0,0,0,0,0,0,0,0,,0,0,0,0,0,0,0,0
397,Fred Onyedinma,eng ENG,"DF,MF",Luton Town,27-157,1996,3,9,5,7,2,0,5,11,45.5,6,2,0,2,1,10,9,0
398,Frank Onyeka,ng NGA,MF,Brentford,26-119,1998,12.8,36,23,9,22,5,15,28,53.6,13,15,7,8,23,59,17,0
399,Divock Origi,be BEL,FW,Nott'ham Forest,29-011,1995,6.7,6,4,5,0,1,0,0,,0,6,0,6,2,8,4,0
400,Stefan Ortega,de GER,GK,Manchester City,31-175,1992,5.8,0,0,0,0,0,0,0,,0,0,0,0,0,0,1,1
401,Ben Osborn,eng ENG,"DF,MF",Sheffield Utd,29-268,1994,14.1,22,9,11,9,2,8,17,47.1,9,16,1,15,8,30,30,0
402,Gabriel Osho,ng NGA,DF,Luton Town,25-259,1998,17.5,34,19,17,16,1,13,23,56.5,10,35,19,16,31,65,78,0
403,William Osula,dk DEN,FW,Sheffield Utd,20-269,2003,8.7,2,2,1,0,1,1,2,50,1,3,1,2,2,4,9,0
404,Dango Ouattara,bf BFA,"FW,DF",Bournemouth,22-078,2002,11.6,36,21,19,7,10,16,29,55.2,13,17,3,14,19,55,31,0
405,David Ozoh,eng ENG,"MF,DF",Crystal Palace,18-334,2005,1.7,10,6,3,6,1,5,6,83.3,1,2,0,2,0,10,2,0
406,João Palhinha,pt POR,MF,Fulham,28-295,1995,27,138,71,71,55,12,95,142,66.9,47,48,8,40,43,181,53,0
407,Cole Palmer,eng ENG,MF,Manchester City,21-359,2002,0.1,0,0,0,0,0,0,0,,0,0,0,0,0,0,0,0
408,Cole Palmer,eng ENG,"FW,MF",Chelsea,21-359,2002,24,21,12,8,5,8,8,19,42.1,11,17,1,16,17,38,11,2
409,Emerson Palmieri,it ITA,DF,West Ham,29-270,1994,32.2,96,61,40,41,15,51,75,68,24,44,13,31,40,136,88,0
410,Lucas Paquetá,br BRA,"FW,MF",West Ham,26-246,1997,26.4,66,45,37,24,5,24,51,47.1,27,26,0,26,21,87,26,2
411,Ben Parkinson,eng ENG,FW,Newcastle Utd,19-050,2005,0.3,0,0,0,0,0,0,0,,0,1,0,1,0,0,1,0
412,Thomas Partey,gh GHA,"MF,DF",Arsenal,30-321,1993,6,10,8,7,2,1,4,6,66.7,2,4,2,2,9,19,5,0
413,Nathan Patterson,sct SCO,DF,Everton,22-196,2001,11.2,34,24,21,11,2,14,37,37.8,23,14,3,11,9,43,33,0
414,Myles Peart-Harris,eng ENG,"DF,MF",Brentford,21-224,2002,0.1,0,0,0,0,0,0,0,,0,0,0,0,0,0,1,0
415,Sydie Peck,eng ENG,MF,Sheffield Utd,19-229,2004,0.1,0,0,0,0,0,0,0,,0,0,0,0,0,0,0,0
416,Facundo Pellistri,uy URU,"FW,MF",Manchester Utd,22-131,2001,1.9,5,3,4,1,0,1,3,33.3,2,7,1,6,1,6,5,0
417,Andreas Pereira,br BRA,MF,Fulham,28-119,1996,27.4,22,11,3,11,8,9,37,24.3,28,15,2,13,4,26,12,0
418,Ivan Perišić,hr CRO,FW,Tottenham,35-087,1989,1.1,3,2,1,1,1,3,5,60,2,1,0,1,2,5,1,0
419,Đorđe Petrović,rs SRB,GK,Chelsea,24-204,1999,17.1,0,0,0,0,0,0,0,,0,0,0,0,0,0,8,2
420,Kalvin Phillips,eng ENG,MF,West Ham,28-149,1995,3.4,11,6,2,8,1,5,9,55.6,4,4,1,3,4,15,2,1
421,Kalvin Phillips,eng ENG,MF,Manchester City,28-149,1995,1,3,3,1,1,1,0,0,,0,0,0,0,2,5,2,0
422,Jaden Philogene Bidace,eng ENG,FW,Aston Villa,22-081,2002,0,0,0,0,0,0,0,0,,0,0,0,0,0,0,0,0
423,Jordan Pickford,eng ENG,GK,Everton,30-053,1994,35,0,0,0,0,0,0,0,,0,3,0,3,0,0,18,1
424,Ethan Pinnock,jm JAM,DF,Brentford,30-336,1993,25,34,23,22,12,0,9,18,50,9,35,22,13,38,72,155,2
425,Nick Pope,eng ENG,GK,Newcastle Utd,32-010,1992,13.9,0,0,0,0,0,0,1,0,1,0,0,0,0,0,7,2
426,Pedro Porro,es ESP,DF,Tottenham,24-229,1999,29.5,83,57,40,29,14,55,105,52.4,50,58,17,41,29,112,94,3
427,Jarell Quansah,eng ENG,DF,Liverpool,21-091,2003,10.2,16,14,10,5,1,8,12,66.7,4,9,3,6,12,28,29,1
428,Ionuț Radu,ro ROU,GK,Bournemouth,26-337,1997,2,0,0,0,0,0,0,0,,0,0,0,0,0,0,0,0
429,Jesurun Rak Sakyi,eng ENG,"MF,FW",Crystal Palace,21-207,2002,1.5,4,1,3,1,0,2,3,66.7,1,2,0,2,3,7,1,0
430,Aaron Ramsdale,eng ENG,GK,Arsenal,25-351,1998,6,0,0,0,0,0,0,0,,0,0,0,0,0,0,3,2
431,Aaron Ramsey,eng ENG,"MF,FW",Burnley,21-099,2003,5.9,17,14,7,5,5,8,16,50,8,11,2,9,1,18,10,0
432,Jacob Ramsey,eng ENG,"FW,MF",Aston Villa,22-337,2001,9.5,16,8,7,6,3,5,15,33.3,10,15,2,13,3,19,8,0
433,Marcus Rashford,eng ENG,FW,Manchester Utd,26-181,1997,25,18,11,8,4,6,8,25,32,17,15,1,14,4,22,19,0
434,David Raya,es ESP,GK,Arsenal,28-227,1995,29,1,1,1,0,0,1,1,100,0,0,0,0,0,1,6,5
435,Tim Ream,us USA,DF,Fulham,36-207,1987,15.7,18,9,11,5,2,7,15,46.7,8,22,15,7,25,43,56,2
436,Nathan Redmond,eng ENG,"FW,MF",Burnley,30-054,1994,1.6,2,1,0,0,2,1,4,25,3,1,0,1,0,2,3,0
437,Harrison Reed,eng ENG,MF,Fulham,29-093,1995,13.9,29,18,9,17,3,13,31,41.9,18,19,9,10,11,40,22,0
438,Sergio Reguilón,es ESP,DF,Manchester Utd,27-135,1996,4.6,13,8,6,2,5,8,17,47.1,9,10,0,10,5,18,7,0
439,Sergio Reguilón,es ESP,DF,Brentford,27-135,1996,9.6,34,16,22,11,1,19,30,63.3,11,19,6,13,12,46,27,0
440,Bobby Reid,jm JAM,FW,Fulham,31-087,1993,15,20,14,4,14,2,4,16,25,12,22,2,20,5,25,14,0
441,Gio Reyna,us USA,"FW,MF",Nott'ham Forest,21-168,2002,2.6,7,3,4,0,3,3,6,50,3,3,0,3,2,9,0,0
442,Rodrigo Ribeiro,pt POR,"MF,FW",Nott'ham Forest,19-001,2005,0.2,0,0,0,0,0,0,1,0,1,1,0,1,1,1,0,0
443,Declan Rice,eng ENG,MF,Arsenal,25-106,1999,32.8,78,47,36,35,7,32,54,59.3,22,34,10,24,41,119,52,0
444,Chris Richards,us USA,"DF,MF",Crystal Palace,24-032,2000,20.3,40,24,19,18,3,18,26,69.2,8,28,10,18,23,63,101,0
445,Richarlison,br BRA,FW,Tottenham,26-355,1997,15.5,16,11,4,8,4,2,9,22.2,7,32,6,26,8,24,21,0
446,Jaïro Riedewald,nl NED,"MF,FW",Crystal Palace,27-233,1996,2.3,8,3,1,4,3,2,5,40,3,0,0,0,2,10,2,0
447,Matt Ritchie,sct SCO,"FW,MF",Newcastle Utd,34-232,1989,1.4,3,2,1,2,0,2,3,66.7,1,3,2,1,1,4,5,0
448,Connor Roberts,wls WAL,DF,Burnley,28-219,1995,9.1,12,5,6,4,2,8,17,47.1,9,8,6,2,4,16,25,2
449,Andrew Robertson,sct SCO,DF,Liverpool,30-049,1994,17.1,32,22,19,11,2,23,38,60.5,15,17,6,11,11,43,40,0
450,Antonee Robinson,us USA,DF,Fulham,26-265,1997,33.4,84,54,54,23,7,49,100,49,51,50,6,44,75,159,104,3
451,Jack Robinson,eng ENG,DF,Sheffield Utd,30-241,1993,29.1,38,25,27,11,0,24,36,66.7,12,46,31,15,30,68,130,2
452,Rodri,es ESP,MF,Manchester City,27-312,1996,28.6,62,39,22,29,11,27,51,52.9,24,28,8,20,22,84,39,4
453,Jay Rodriguez,eng ENG,FW,Burnley,34-275,1989,9,14,9,7,4,3,7,13,53.8,6,11,1,10,1,15,8,0
454,Mads Roerslev,dk DEN,DF,Brentford,24-310,1999,20.5,42,26,30,8,4,26,52,50,26,14,3,11,19,61,68,0
455,Morgan Rogers,eng ENG,"MF,FW",Aston Villa,21-278,2002,6.8,8,1,3,2,3,2,11,18.2,9,11,0,11,2,10,11,0
456,Cristian Romero,ar ARG,DF,Tottenham,26-002,1998,26,58,37,34,20,4,32,42,76.2,10,37,18,19,36,94,88,1
457,Joe Rothwell,eng ENG,MF,Bournemouth,29-109,1995,4.3,7,2,4,2,1,2,8,25,6,4,2,2,3,10,2,0
458,Pelly Ruddock Mpanzu,cd COD,MF,Luton Town,30-287,1993,12,12,4,5,6,1,5,9,55.6,4,15,7,8,9,21,15,3
459,José Sá,pt POR,GK,Wolves,31-103,1993,31.7,0,0,0,0,0,0,1,0,1,3,0,3,0,0,20,5
460,Dominic Sadi,eng ENG,FW,Bournemouth,20-240,2003,0,0,0,0,0,0,0,0,,0,0,0,0,0,0,0,0
461,Bukayo Saka,eng ENG,FW,Arsenal,22-237,2001,30.6,64,34,21,23,20,26,57,45.6,31,41,2,39,14,78,22,1
462,Mohamed Salah,eg EGY,FW,Liverpool,31-319,1992,25.2,14,9,1,5,8,5,18,27.8,13,18,1,17,2,16,1,0
463,William Saliba,fr FRA,DF,Arsenal,23-036,2001,35,34,21,22,11,1,16,22,72.7,6,29,15,14,27,61,74,3
464,Albert Sambi Lokonga,be BEL,MF,Luton Town,24-190,1999,11.5,24,16,12,10,2,14,20,70,6,20,12,8,6,30,11,0
465,Davinson Sánchez,co COL,DF,Tottenham,27-322,1996,0.9,0,0,0,0,0,0,0,,0,3,2,1,1,1,2,0
466,Robert Sánchez,es ESP,GK,Chelsea,26-163,1997,15.9,0,0,0,0,0,0,0,,0,0,0,0,0,0,11,3
467,Jadon Sancho,eng ENG,"FW,MF",Manchester Utd,24-035,2000,0.9,1,0,1,0,0,1,3,33.3,2,1,0,1,1,2,0,0
468,Ibrahim Sangaré,ci CIV,MF,Nott'ham Forest,26-149,1997,11.1,42,22,25,13,4,12,29,41.4,17,23,6,17,14,56,20,0
469,Andrey Santos,br BRA,MF,Nott'ham Forest,19-362,2004,0.1,0,0,0,0,0,0,0,,0,1,0,1,0,0,0,0
470,Pablo Sarabia,es ESP,"MF,FW",Wolves,31-354,1992,18.9,19,12,8,7,4,11,34,32.4,23,17,1,16,9,28,9,0
471,Dane Scarlett,eng ENG,FW,Tottenham,20-036,2004,0,0,0,0,0,0,0,1,0,1,0,0,0,0,0,0,0
472,Kevin Schade,de GER,FW,Brentford,22-154,2001,3.2,3,1,1,2,0,0,4,0,4,1,0,1,1,4,4,0
473,Fabian Schär,ch SUI,DF,Newcastle Utd,32-131,1991,32.6,41,24,27,13,1,17,39,43.6,22,48,36,12,36,77,129,1
474,Jeffrey Schlupp,gh GHA,"FW,MF",Crystal Palace,31-128,1992,14.9,37,23,14,16,7,9,18,50,9,13,2,11,8,45,24,0
475,Alex Scott,eng ENG,MF,Bournemouth,20-252,2003,10.1,22,13,7,10,5,11,25,44,14,14,4,10,12,34,14,2
476,Matz Sels,be BEL,GK,Nott'ham Forest,32-063,1992,13,0,0,0,0,0,0,0,,0,0,0,0,0,0,10,0
477,Nélson Semedo,pt POR,"DF,MF",Wolves,30-165,1993,32,70,43,45,17,8,33,56,58.9,23,39,8,31,33,103,83,1
478,Antoine Semenyo,gh GHA,"FW,MF",Bournemouth,24-113,2000,20.4,22,15,7,8,7,8,25,32,17,33,2,31,6,28,19,0
479,Marcos Senesi,ar ARG,DF,Bournemouth,26-355,1997,22.1,48,27,25,21,2,19,47,40.4,28,42,18,24,28,76,97,1
480,Luke Shaw,eng ENG,DF,Manchester Utd,28-292,1995,10.7,11,8,7,3,1,9,15,60,6,18,11,7,6,17,39,0
481,Bernardo Silva,pt POR,"MF,FW",Manchester City,29-263,1994,24.8,47,22,12,23,12,23,51,45.1,28,22,3,19,16,63,12,1
482,Fábio Silva,pt POR,FW,Wolves,21-285,2002,2.9,7,4,3,4,0,2,3,66.7,1,1,0,1,2,9,0,0
483,Thiago Silva,br BRA,DF,Chelsea,39-220,1984,25.2,26,12,21,4,1,17,30,56.7,13,30,21,9,25,51,124,4
484,Luis Sinisterra,co COL,"FW,MF",Bournemouth,24-317,1999,7.8,23,12,9,10,4,9,16,56.3,7,18,0,18,8,31,4,0
485,Oliver Skipp,eng ENG,"MF,FW",Tottenham,23-226,2000,6.5,15,10,7,5,3,8,14,57.1,6,11,1,10,1,16,7,0
486,Adam Smith,eng ENG,DF,Bournemouth,33-000,1991,22,33,21,15,10,8,17,33,51.5,16,24,11,13,21,54,56,0
487,Emile Smith Rowe,eng ENG,MF,Arsenal,23-276,2000,3.7,4,1,2,2,0,2,4,50,2,3,1,2,3,7,1,0
488,Cédric Soares,pt POR,DF,Arsenal,32-242,1991,0.7,0,0,0,0,0,0,0,,0,0,0,0,0,0,0,0
489,Dominic Solanke,eng ENG,FW,Bournemouth,26-228,1997,34.6,23,11,3,13,7,10,26,38.5,16,23,5,18,7,30,40,0
490,Manor Solomon,il ISR,FW,Tottenham,24-280,1999,2.2,3,3,1,1,1,1,2,50,1,4,0,4,3,6,2,0
491,Tomáš Souček,cz CZE,MF,West Ham,29-062,1995,28.9,48,33,20,25,3,19,43,44.2,24,51,27,24,37,85,96,0
492,Vinicius Souza,br BRA,MF,Sheffield Utd,24-317,1999,27.5,121,75,58,48,15,38,71,53.5,33,51,16,35,30,151,70,1
493,Jason Steele,eng ENG,GK,Brighton,33-255,1990,16,0,0,0,0,0,0,3,0,3,0,0,0,0,0,8,1
494,Raheem Sterling,eng ENG,"FW,MF",Chelsea,29-143,1994,20.8,20,10,7,7,6,11,25,44,14,12,0,12,12,32,8,1
495,John Stones,eng ENG,"DF,MF",Manchester City,29-337,1994,11.6,2,1,1,0,1,0,3,0,3,11,7,4,10,12,21,0
496,Thomas Strakosha,al ALB,GK,Brentford,29-041,1995,1.5,0,0,0,0,0,0,0,,0,0,0,0,0,0,0,0
497,Dominik Szoboszlai,hu HUN,MF,Liverpool,23-187,2000,23,32,19,12,12,8,16,50,32,34,37,2,35,14,46,16,1
498,Matt Targett,eng ENG,DF,Newcastle Utd,28-224,1995,0.9,2,0,1,1,0,1,1,100,0,1,0,1,0,2,2,0
499,James Tarkowski,eng ENG,DF,Everton,31-162,1992,35,55,37,40,14,1,27,46,58.7,19,72,47,25,55,110,175,2
500,Nuno Tavares,pt POR,DF,Nott'ham Forest,24-094,2000,5.1,11,7,9,1,1,8,9,88.9,1,6,0,6,1,12,21,0
501,Marcus Tavernier,eng ENG,FW,Bournemouth,25-038,1999,22.6,50,32,24,21,5,23,45,51.1,22,30,3,27,5,55,23,0
502,Charlie Taylor,eng ENG,DF,Burnley,30-224,1993,24.1,34,19,19,13,2,17,35,48.6,18,25,10,15,18,52,77,0
503,Kenny Tete,nl NED,DF,Fulham,28-203,1995,8.6,22,15,15,5,2,9,17,52.9,8,10,3,7,16,38,33,0
504,Luke Thomas,eng ENG,DF,Sheffield Utd,22-324,2001,10.2,20,9,13,6,1,8,14,57.1,6,23,5,18,10,30,27,0
505,Youri Tielemans,be BEL,"MF,FW",Aston Villa,26-358,1997,17.3,40,19,17,17,6,16,38,42.1,22,21,2,19,14,54,8,0
506,Jurriën Timber,nl NED,DF,Arsenal,22-317,2001,0.5,1,1,0,1,0,0,0,,0,0,0,0,0,1,1,0
507,Harry Toffolo,eng ENG,DF,Nott'ham Forest,28-254,1995,14.9,25,13,20,5,0,14,23,60.9,9,32,12,20,13,38,44,0
508,Takehiro Tomiyasu,jp JPN,DF,Arsenal,25-176,1998,9.8,14,8,11,2,1,9,15,60,6,6,3,3,14,28,25,0
509,James Tomkins,eng ENG,DF,Crystal Palace,35-031,1989,0.1,0,0,0,0,0,0,0,,0,0,0,0,1,1,0,0
510,Sandro Tonali,it ITA,MF,Newcastle Utd,23-357,2000,4.9,7,7,4,2,1,3,9,33.3,6,3,0,3,2,9,4,0
511,Ivan Toney,eng ENG,FW,Brentford,28-044,1996,13.1,13,5,2,6,5,6,13,46.2,7,4,1,3,9,22,16,0
512,Pau Torres,es ESP,DF,Aston Villa,27-104,1997,25.4,26,15,16,9,1,13,28,46.4,15,25,11,14,13,39,68,0
513,Andros Townsend,eng ENG,"MF,FW",Luton Town,32-288,1991,13.2,21,13,11,2,8,13,27,48.1,14,12,0,12,5,26,10,0
514,James Trafford,eng ENG,GK,Burnley,21-202,2002,28,2,1,2,0,0,2,2,100,0,0,0,0,1,3,18,1
515,Adama Traoré,es ESP,"FW,MF",Fulham,28-095,1996,2.5,4,3,1,2,1,3,6,50,3,1,0,1,1,5,1,0
516,Bertrand Traoré,bf BFA,"DF,FW",Aston Villa,28-236,1995,0.1,1,1,1,0,0,0,0,,0,0,0,0,0,1,1,0
517,Boubacar Traoré,ml MLI,MF,Wolves,22-253,2001,7.3,29,19,16,12,1,8,18,44.4,10,11,2,9,5,34,6,0
518,Mark Travers,ie IRL,GK,Bournemouth,24-347,1999,2,0,0,0,0,0,0,0,,0,0,0,0,0,0,1,0
519,Mike Trésor,be BEL,"FW,MF",Burnley,24-337,1999,4.6,10,6,9,1,0,8,17,47.1,9,5,0,5,1,11,1,0
520,Kieran Trippier,eng ENG,DF,Newcastle Utd,33-223,1990,24,57,27,30,16,11,37,76,48.7,39,38,8,30,23,80,55,3
521,Leandro Trossard,be BEL,"FW,MF",Arsenal,29-147,1994,15.8,23,15,8,7,8,7,17,41.2,10,22,1,21,6,29,6,0
522,Auston Trusty,us USA,DF,Sheffield Utd,25-261,1998,25.6,43,27,28,12,3,19,39,48.7,20,39,21,18,32,75,135,3
523,Kostas Tsimikas,gr GRE,DF,Liverpool,27-353,1996,7.5,19,13,9,6,4,9,15,60,6,9,1,8,6,25,10,0
524,Matt Turner,us USA,GK,Nott'ham Forest,29-310,1994,17,0,0,0,0,0,0,0,,0,0,0,0,0,0,8,4
525,Destiny Udogie,it ITA,DF,Tottenham,21-153,2002,26.6,68,33,41,16,11,27,49,55.1,22,27,8,19,37,105,80,5
526,Lesley Ugochukwu,fr FRA,MF,Chelsea,20-034,2004,3,12,9,3,8,1,3,8,37.5,5,5,2,3,1,13,3,0
527,Enes Ünal,tr TUR,"FW,MF",Bournemouth,26-355,1997,2.5,6,4,2,3,1,2,5,40,3,3,2,1,1,7,5,0
528,Virgil van Dijk,nl NED,DF,Liverpool,32-296,1991,32.3,38,22,22,13,3,11,13,84.6,2,42,30,12,36,74,131,0
529,Raphaël Varane,fr FRA,DF,Manchester Utd,31-004,1993,15,18,11,10,7,1,10,14,71.4,4,22,17,5,15,33,88,0
530,Alejo Véliz,ar ARG,FW,Tottenham,20-223,2003,0.6,1,0,1,0,0,0,0,,0,0,0,0,0,1,0,0
531,Joël Veltman,nl NED,DF,Brighton,32-105,1992,16.2,49,38,27,17,5,34,51,66.7,17,17,7,10,16,65,56,1
532,Micky van de Ven,nl NED,DF,Tottenham,23-010,2001,21,42,29,30,9,3,20,28,71.4,8,16,11,5,16,58,65,0
533,Bart Verbruggen,nl NED,GK,Brighton,21-255,2002,18,1,1,1,0,0,1,1,100,0,0,0,0,0,1,7,3
534,Guglielmo Vicario,it ITA,GK,Tottenham,27-205,1996,33,0,0,0,0,0,0,1,0,1,0,0,0,1,1,29,2
535,Fabio Vieira,pt POR,"MF,FW",Arsenal,23-335,2000,3.3,3,2,2,0,1,3,3,100,0,0,0,0,2,5,2,0
536,Carlos Vinícius,br BRA,FW,Fulham,29-035,1995,3.5,3,2,0,1,2,0,4,0,4,4,0,4,0,3,1,0
537,Vitinho,br BRA,"DF,MF",Burnley,24-281,1999,23.4,60,31,34,20,6,41,83,49.4,42,40,5,35,11,71,42,4
538,Odisseas Vlachodimos,gr GRE,GK,Nott'ham Forest,30-003,1994,5,0,0,0,0,0,0,1,0,1,0,0,0,0,0,1,0
539,Kyle Walker,eng ENG,DF,Manchester City,33-337,1990,27,30,20,15,13,2,16,36,44.4,20,17,5,12,23,53,36,1
540,Aaron Wan-Bissaka,eng ENG,DF,Manchester Utd,26-155,1997,15.8,37,23,17,16,4,17,23,73.9,6,22,12,10,33,70,59,1
541,Joel Ward,eng ENG,DF,Crystal Palace,34-183,1989,22,45,28,26,18,1,30,47,63.8,17,17,10,7,14,59,93,1
542,James Ward-Prowse,eng ENG,MF,West Ham,29-180,1994,30.8,45,29,14,23,8,18,39,46.2,21,29,8,21,34,79,45,0
543,Deivid Washington,br BRA,"DF,FW",Chelsea,18-329,2005,0.1,1,1,1,0,0,0,1,0,1,0,0,0,0,1,0,0
544,Ollie Watkins,eng ENG,FW,Aston Villa,28-121,1995,33,11,6,0,4,7,5,11,45.5,6,24,4,20,4,15,20,0
545,Adam Webster,eng ENG,DF,Brighton,29-116,1995,8.7,11,11,8,2,1,6,15,40,9,8,5,3,9,20,33,1
546,Danny Welbeck,eng ENG,"FW,MF",Brighton,33-155,1990,15.6,22,9,6,11,5,7,14,50,7,11,0,11,9,31,17,1
547,Timo Werner,de GER,FW,Tottenham,28-054,1996,9,7,4,3,4,0,5,18,27.8,13,12,0,12,3,10,2,0
548,Adam Wharton,eng ENG,MF,Crystal Palace,19-332,2004,11.5,40,27,16,18,6,22,39,56.4,17,14,2,12,16,56,20,1
549,Ethan Wheatley,eng ENG,FW,Manchester Utd,18-100,2006,0,0,0,0,0,0,0,0,,0,1,0,1,1,1,0,0
550,Ben White,eng ENG,DF,Arsenal,26-204,1997,30.4,44,27,17,22,5,22,43,51.2,21,42,20,22,29,73,74,1
551,Joe White,eng ENG,MF,Newcastle Utd,21-211,2002,0.1,1,1,1,0,0,0,0,,0,0,0,0,0,1,0,0
552,Neco Williams,wls WAL,DF,Nott'ham Forest,23-016,2001,18.2,69,40,42,18,9,35,56,62.5,21,44,13,31,22,91,53,0
553,Willian,br BRA,FW,Fulham,35-264,1988,21.6,15,9,5,5,5,3,19,15.8,16,13,0,13,9,24,12,0
554,Joe Willock,eng ENG,MF,Newcastle Utd,24-253,1999,4.7,13,7,7,6,0,4,11,36.4,7,7,0,7,1,14,1,0
555,Callum Wilson,eng ENG,FW,Newcastle Utd,32-062,1992,10.1,5,3,0,2,3,0,4,0,4,5,0,5,2,7,3,0
556,Harry Wilson,wls WAL,FW,Fulham,27-038,1997,16.8,21,14,9,8,4,11,27,40.7,16,27,3,24,10,31,11,0
557,Yoane Wissa,cd COD,FW,Brentford,27-239,1996,26.2,28,16,13,10,5,5,19,26.3,14,23,3,20,9,37,13,0
558,Chris Wood,nz NZL,FW,Nott'ham Forest,32-144,1991,17.3,5,3,1,2,2,1,6,16.7,5,10,2,8,1,6,24,0
559,Cauley Woodrow,eng ENG,"FW,MF",Luton Town,29-149,1994,4.3,15,10,7,4,4,8,15,53.3,7,5,1,4,0,15,12,0
560,Joe Worrall,eng ENG,DF,Nott'ham Forest,27-110,1997,4.9,7,5,6,1,0,3,6,50,3,5,4,1,3,10,32,1
561,Yehor Yarmoliuk,ua UKR,MF,Brentford,20-059,2004,7.2,15,10,5,7,3,7,13,53.8,6,15,3,12,6,21,5,0
562,Ryan Yates,eng ENG,MF,Nott'ham Forest,26-160,1997,19.7,55,34,32,17,6,15,29,51.7,14,42,15,27,20,75,39,1
563,Ashley Young,eng ENG,"DF,MF",Everton,38-295,1985,22.6,43,30,20,17,6,24,46,52.2,22,21,5,16,22,65,43,2
564,Illia Zabarnyi,ua UKR,DF,Bournemouth,21-241,2002,34,57,31,28,28,1,23,47,48.9,24,44,28,16,32,89,134,4
565,Nicolò Zaniolo,it ITA,"FW,MF",Aston Villa,24-302,1999,9.2,19,9,10,7,2,9,17,52.9,8,13,0,13,1,20,11,0
566,Anass Zaroury,ma MAR,"FW,MF",Burnley,23-174,2000,1.7,1,0,1,0,0,0,4,0,4,2,0,2,0,1,1,1
567,Oleksandr Zinchenko,ua UKR,DF,Arsenal,27-136,1996,18.8,50,30,19,24,7,35,52,67.3,17,18,3,15,20,70,26,2
568,Kurt Zouma,fr FRA,DF,West Ham,29-185,1994,28.5,19,14,11,8,0,7,13,53.8,6,34,24,10,24,43,144,0
569,Martin Ødegaard,no NOR,MF,Arsenal,25-134,1998,31.4,45,16,15,21,9,15,52,28.8,37,22,1,21,13,58,5,0